9 1
1 1 1 1 1 1 1 1 2 
5 23 16 16 11 20 9 1 24 
1 1 1 1 1 1 9 1 6 
4 12 1 19 19 0 13 21 3 
1 0 0 13 1 0 1 1 8 
1 1 14 0 1 0 0 20 12 
7 1 0 0 1 1 0 1 10 
23 1 21 1 1 9 11 1 23 
0 0 0 0 15 0 0 1 18 
1 5 8 没有拜访僧人之前请不要往左走
1 2 6 左边很安全，你可以捡到好东西
1 7 6 上面比较危险，没有足够的生命值千万不能去
1 4 5 里面很危险！
1 9 4 你最好等到生命值很低的时候再去下面，里面有很好的东西！
1 7 2 这里3格以内有很好的东西！
