10 1
23 5 16 1 8 8 8 6 13 3 
17 1 0 1 8 12 8 1 2 24 
17 1 0 17 8 1 8 1 1 1 
16 16 14 1 12 1 0 0 16 4 
16 1 20 14 1 21 7 9 16 9 
17 1 21 1 16 1 1 1 9 3 
16 11 13 0 0 0 9 1 3 1 
14 10 3 22 3 3 10 1 17 17 
11 1 4 1 1 3 18 1 16 17 
0 14 14 14 1 3 1 1 17 23 
1 9 10 千万不要去下面
1 6 9 四个角上都很危险
1 5 7 能否通过上面的考验很考人品
1 2 4 我只是一个无辜的路牌
1 3 4 别往上
1 1 2 充分利用道具，不然你会吃亏的
