15 1
22 1 21 0 0 13 15 17 0 20 0 8 6 24 2 
23 1 0 1 4 1 0 1 0 1 9 1 1 1 1 
6 1 9 12 16 0 0 3 0 16 0 0 14 0 21 
8 1 0 1 0 1 1 1 1 1 0 1 0 1 16 
11 0 16 0 7 17 19 13 12 0 15 0 12 3 0 
20 1 0 1 0 1 1 16 1 1 0 1 0 1 0 
0 0 14 0 0 1 5 16 9 1 0 0 16 0 10 
0 1 0 1 15 1 3 1 3 1 3 1 0 1 12 
15 0 0 19 13 1 5 10 5 1 0 9 13 4 0 
3 1 4 1 0 1 1 1 1 1 17 1 0 1 20 
19 0 16 0 0 8 8 8 8 8 21 0 0 0 11 
12 1 0 1 17 1 4 1 0 1 0 1 7 1 8 
14 0 9 0 0 0 16 0 15 0 0 19 0 1 6 
1 1 1 1 11 1 0 1 13 1 0 1 0 1 23 
0 9 14 9 11 11 17 0 14 3 0 20 16 1 18 
1 6 15 右边很危险！
1 4 13 右边比较危险
1 1 11 (1,6)和(8,13)是陷阱;(3,11)和(5,13)是怪物
1 8 11 下面什么也没有......
1 9 11 左边的是小人//你最好不要去(8,7)......
1 13 11 不要去右边......
1 15 8 上面很危险
1 5 7 不要去上面！
1 13 7 左边很安全，但是右边很危险！
1 15 5 (10,1)和(11,8)是陷阱;(13,1)和(15,12)是怪物
1 1 4 上面很安全//下面很安全......
1 5 2 友情提示2：有5个小人和5个君子......
1 9 2 千万不要去上面......
1 5 1 友情提示：四个角上都有好东西！所以......越早到越好,但是在这之前可以去中间（当然也可以先不去，但那是迟早要去的）
1 6 1 (14,15)是BOSS！
