17 1
1 1 1 1 1 1 1 1 21 1 8 8 8 8 8 8 7 
22 4 3 14 3 4 18 1 21 1 8 1 1 1 1 1 8 
1 1 1 6 1 1 1 1 19 1 8 1 3 6 11 1 8 
1 1 1 0 0 0 19 1 20 1 8 1 24 1 8 1 8 
1 1 1 1 1 5 0 1 19 1 8 1 2 1 8 8 8 
1 1 1 1 1 1 16 1 20 1 8 1 1 1 24 1 1 
9 0 17 0 0 1 16 1 6 1 8 8 14 13 11 9 9 
1 0 0 17 0 1 4 1 13 1 1 1 1 1 1 1 16 
1 0 0 0 17 0 0 1 11 1 3 0 14 0 0 0 0 
23 0 11 0 0 17 0 11 16 1 0 0 0 4 0 0 0 
1 1 17 0 1 1 1 1 3 1 11 0 0 0 14 0 16 
1 1 1 15 20 6 1 1 0 0 11 1 4 1 0 21 0 
1 1 21 11 1 5 3 1 0 9 11 16 1 16 0 0 20 
1 1 1 10 1 19 12 1 1 17 1 1 5 1 1 1 11 
14 15 14 13 1 1 12 1 4 13 12 16 23 0 0 1 0 
17 1 15 9 8 12 12 1 1 1 1 1 22 1 0 1 0 
0 17 14 9 1 12 12 1 1 1 1 1 1 1 15 3 0 
1 15 15 你需要1个钥匙，1条绳子及强大的攻击力或道具！
1 14 11 当然，这是要付出代价的......左边一格极其危险！请小心......
1 15 11 如果你很强大，就往上走；如果你想碰运气，那么往左
1 9 10 这里面是武器室！赶快进去拿吧！只需要一把钥匙哦~
1 9 9 记住：切勿有贪念！
1 3 8 (7,4)是君子......所以......
1 8 8 让我来告诉你这个地图的惊天大秘密！（也许现在已经晚了，但是我还是要告诉你......）如果你之前在（4,4）牺牲一点东西的话，也许后面的人和路牌说的话可以忽略掉......
1 11 7 又是这样......（作者实在不想编了！空间太大了。无力吐槽啊！）别忘了前面的忠告
1 11 6 往下走
1 4 5 不去下面就对了！
1 11 5 右边3*3区域摆成了一个5点的形状......东边和西边都是不好的
1 7 4 其实你不一定要所有地方都走的......
1 17 4 这是连通器
1 4 3 这确定一定以及肯定是你碰到的第一个君子！往上走就对了~
1 7 3 接下来的旅途一定会令你非常开心的！相信我哦^_^
1 10 3 左边很危险
1 11 3 可以不要那么早走这里，或许你可以走另外一边......
1 6 2 无语
1 7 2 无语
1 6 1 无语
1 7 1 无语
