22 1
16 16 16 13 9 0 0 0 19 0 1 0 11 0 10 1 21 0 0 9 17 5 
5 1 1 1 0 1 17 0 0 0 9 0 1 1 0 1 4 0 1 23 1 7 
1 1 1 1 16 1 0 1 1 0 1 1 1 1 10 1 1 6 1 10 1 1 
14 0 15 1 0 0 0 16 0 0 8 0 0 1 5 1 0 11 11 11 0 8 
0 9 0 1 0 9 1 15 1 1 1 12 0 1 1 1 0 1 1 1 1 0 
20 0 19 1 1 9 1 11 1 8 8 0 11 0 9 6 14 0 19 0 1 17 
1 1 23 1 1 16 1 1 1 1 1 1 6 1 1 1 0 0 12 0 1 0 
7 1 3 1 4 0 1 2 1 18 23 0 8 6 24 1 1 1 10 0 15 0 
23 1 12 0 0 0 1 24 1 1 1 1 1 1 4 1 1 1 1 1 1 16 
9 1 1 1 1 0 1 0 23 1 0 3 1 8 9 1 22 9 23 23 11 0 
3 21 16 14 11 0 1 23 0 0 16 0 11 9 21 1 1 9 21 1 0 0 
1 1 1 1 1 20 1 1 1 1 1 1 1 1 1 1 1 1 1 1 1 16 
21 0 9 23 12 0 0 16 0 0 9 0 0 0 1 3 20 6 13 13 13 0 
0 1 0 1 1 14 11 0 1 0 1 1 17 0 1 1 1 1 1 1 1 0 
4 0 20 1 17 0 0 0 1 19 1 1 1 6 1 11 0 16 0 1 1 19 
23 1 16 1 0 1 1 0 1 0 1 12 0 9 1 14 1 1 4 0 0 0 
0 1 3 1 12 3 4 0 17 0 1 0 1 1 1 1 1 8 0 0 1 12 
6 1 7 1 0 1 0 1 1 0 1 0 11 10 8 10 1 20 0 21 1 0 
5 1 1 1 0 1 0 9 1 16 1 0 1 1 1 1 1 3 0 1 1 3 
5 1 0 21 19 13 16 1 1 0 1 0 1 1 0 23 0 12 16 8 1 23 
1 1 4 0 0 1 1 1 15 0 1 0 1 1 0 1 1 0 1 1 1 11 
0 0 15 0 17 1 1 8 21 0 1 12 0 0 17 1 1 8 1 23 7 21 
1 4 22 左边只有怪物，千万不要去
1 13 22 温馨提示：由于本地图有很多的...，所以快点找到商人比较好
1 18 19 去右边
1 19 19 左上方是门，右上方是地雷和进阶怪物，你想走哪边？
1 20 19 去左边
1 12 18 random！
1 8 17 终点在哪里？很近了...
1 13 17 附近门很密集
1 19 16 最好不要去下面
1 3 14 上面是宝库，不过...
1 21 13 如果你有实力，请去左边试试
1 5 12 左边一路你会遇到许多东西
1 13 12 没错，你踏上了终点的路，接下来没有道具可以捡了，尽量避免走多余的路
1 5 10 小心左边哦，准备好了再过去
1 19 10 对、对，一直往左走
1 20 10 左边真的有好东西
1 21 10 左边有好东西
1 7 9 温馨提示：如果你想打开所有的门，你的钥匙是不够的
1 16 8 据说附近有一个大阴谋，你遇到了吗？
1 12 7 走廊...
1 5 6 走上面，别走右边
1 22 6 小心
1 13 5 也许你需要照照右边是什么
1 6 3 快点去右边
1 18 3 如果你有闪光灯，请在此使用
1 22 2 不要有贪婪之心
1 12 1 走廊...
