10 1
5 1 1 1 12 0 23 19 1 2 
3 16 0 1 0 1 1 21 1 24 
1 1 11 1 12 3 1 1 1 6 
14 0 0 8 0 13 0 20 0 3 
0 1 1 1 9 0 0 1 1 0 
16 11 0 1 1 1 16 1 1 9 
1 1 9 0 0 0 11 0 0 0 
1 15 16 1 1 12 1 1 14 0 
1 1 0 19 1 0 10 1 1 1 
0 11 4 0 1 1 0 4 16 18 
1 5 10 加油
1 3 8 easy one！
1 5 8 不要去右边
1 6 7 快点去上面
1 2 5 你不一定要往左走的
1 7 4 别着急去（10，7）
1 6 3 要小心了
1 2 1 本局的难点在于打败Boss，祝一路顺风
