20 1
5  0  23 0  0  0  13 20 1  6  0  3  0  11 17 9  0  0  24 2
1  7  1  1  15 0  1  1  1  0  1  1  0  0  19 8  0  3  1  1
1  1  1  16 0  0  1  1  1  20 1  1  1  1  1  1  1  1  1  3
0  0  14 0  1  1  1  1  1  0  8  1  1  19 0  1  0  0  0  13
17 1  1  0  1  0  0  13 0  0  0  0  0  0  0  1  16 1  1  0
0  1  1  9  1  10 1  1  1  1  1  1  1  1  11 1  0  1  1  8
0  0  4  22 1  3  1  1  0  16 13 17 15 16 0  1  17 0  1  8
23 1  1  1  1  1  1  11 0  3  13 9  21 10 0  1  0  0  1  8
0  1  9  0  0  8  0  0  1  1  1  1  1  1  1  1  0  0  1  11
12 1  1  1  1  0  0  0  1  14 0  7  1  0  0  0  20 20 0  0
0  0  7  16 1  1  1  16 1  0  0  16 1  0  3  0  1  1  1  0
0  4  0  0  1  17 0  0  1  3  1  1  1  0  12 12 0  0  0  0
0  0  0  0  1  0  0  21 1  13 0  0  0  0  1  15 1  1  0  21
21 0  17 0  1  1  1  0  1  1  1  1  1  0  1  0  1  1  0  0
1  1  1  11 1  19 0  0  0  3  0  11 23 0  4  0  0  1  1  0
9  0  0  4  1  0  0  0  1  1  1  0  1  1  1  1  0  14 1  10
0  0  1  1  1  1  0  1  1  4  1  0  1  0  3  1  0  0  16 0
16 19 1  3  12 0  0  1  0  0  1  0  0  9  0  1  1  1  18 1
11 1  1  1  20 1  16 0  0  0  0  0  1  0  11 0  13 1  1  1
0  0  4  0  0  1  1  0  14 1  3  0  0  0  1  0  11 8  16 12
1 1 2 上面是一条探险道路，请小心
1 1 11 请勿过早往上走
1 4 6 上面是一个4×4的方格区域，大部分是好东西
1 5 3 不要去左边
1 7 20 千万不要往右走
1 8 13 右边是一个2×N的大道，上下相邻的两格相同或属性相近
1 8 16 有足够的生命值才可往里走
1 10 8 上面是一根绳子
1 11 13 右边很危险
1 11 14 （18,19）处有好东西
1 12 6 小心！
1 14 20 有趣的地方
1 15 2 往右走你可得到一些信息
1 15 9 上面很危险，右边是君子
1 15 15 你至少需要一条绳子
1 16 9 下面很安全，左边是君子
1 17 1 本地图共有5个君子，7个小人，8个路牌
1 17 2 （6，14）对你有帮助 
1 20 1 在地图右下角3×3的区域内，除我外还有一个人
20 12 上面有三瓶酒
20 17 快要到终点了