10 1
2 16 1 1 9 15 23 6 0 21 
3 24 8 17 8 1 1 1 10 0 
1 1 1 1 1 1 21 1 1 14 
17 0 3 9 13 16 13 0 9 23 
0 17 1 12 3 1 19 20 1 23 
16 1 1 8 1 1 0 0 1 22 
21 1 1 0 0 1 3 20 1 7 
0 0 0 20 0 16 12 16 1 5 
1 1 4 1 19 1 10 1 1 1 
0 11 0 17 0 1 13 4 4 18 
1 5 7 左边很危险，右边很安全
1 7 7 不要去上面
1 4 6 右边很危险，上面很安全
1 7 3 小心我的四周
1 2 1 要学会利用自己的道具（如灯泡、手电筒）
1 7 1 你需要有两条绳子才能到右边去
