13 1
18 1 3 0 12 12 23 9 23 0 9 9 24 
6 1 17 0 1 6 1 6 1 1 0 24 5 
22 1 17 1 0 24 1 0 4 1 1 15 1 
23 1 17 5 1 3 1 24 1 0 3 3 6 
3 1 16 1 8 8 1 0 7 1 1 23 1 
4 0 9 5 1 1 5 1 1 1 5 14 21 
4 1 1 5 6 5 5 1 22 15 23 23 14 
3 1 15 1 23 1 5 1 4 1 0 23 5 
16 1 16 20 6 17 6 17 4 0 1 6 1 
13 1 0 19 3 21 3 0 4 24 24 7 1 
12 1 10 21 1 7 9 1 6 1 3 3 3 
4 5 9 1 10 1 16 1 24 6 1 3 1 
0 7 7 12 12 12 13 24 1 24 6 3 2 
5 13 先去左上
6 13 门不要乱开
1 4 不要向上！
1 3 向上！
4 1 不要再向右走了
5 1 我再说一次，不要再向右走了！
6 1 你为什么不听呢！
7 1 立刻返回
