14 1
22 3 9 16 13 4 0 1 17 3 16 1 16 2 
3 1 1 1 0 1 0 16 0 1 18 1 0 3 
9 1 1 1 8 1 1 14 1 1 9 1 0 11 
16 1 1 1 0 1 21 0 0 1 1 1 1 6 
13 0 8 0 11 0 0 1 0 17 1 5 1 24 
0 1 1 1 0 1 19 1 1 0 1 7 1 13 
16 0 20 0 0 0 12 3 0 0 0 23 1 6 
17 1 1 1 1 1 1 1 1 1 1 12 1 0 
0 14 0 0 17 1 4 0 0 17 0 9 1 9 
16 1 0 1 16 0 0 0 1 0 15 0 1 0 
20 0 21 1 0 0 20 0 1 3 0 8 16 0 
0 1 1 1 0 1 1 15 1 0 1 1 1 1 
4 1 17 0 0 19 1 0 16 4 1 1 17 10 
0 9 0 0 1 0 0 0 1 13 0 23 12 5 
1 5 14 先往下走会吃亏的
1 14 12 最后的选择
1 1 10 先往右走会吃亏的
1 5 10 记住，左上角6×6区域以某条轴对称
1 14 9 这张地图没有Boss哦
1 7 8 去上面，别去右边
1 12 7 小心
1 10 1 建议早点去右边
1 13 1 千万不要得寸进尺