15 1
4 23 16 17 10 19 20 0 6 23 8 5 8 1 11 
23 1 1 16 1 1 1 1 1 14 4 8 1 1 24 
9 8 16 17 0 1 21 0 1 8 8 1 2 1 10 
9 1 0 1 0 16 0 16 1 22 1 7 24 1 6 
9 8 16 0 17 4 1 0 0 1 21 16 24 6 13 
16 1 1 9 1 17 0 20 0 1 1 1 1 1 8 
16 8 16 0 17 0 16 1 16 1 5 5 23 6 8 
16 1 1 1 1 1 1 4 6 1 1 1 1 1 8 
12 3 3 8 8 8 0 1 10 1 17 17 17 6 8 
8 1 1 1 1 8 21 1 23 1 1 1 1 1 8 
16 1 18 14 5 1 21 1 7 1 5 5 23 6 8 
17 1 9 20 19 1 16 14 1 1 1 1 1 1 8 
16 1 17 14 4 1 16 1 21 1 21 21 23 6 8 
11 1 1 1 13 1 0 1 23 1 1 1 1 1 8 
0 7 7 7 7 1 3 5 3 17 10 17 5 6 11 
1 15 15 终点在走廊左边最后一扇门的最深处
1 15 11 终点在上面
1 1 7 艰辛的旅程即将开始~
1 1 2 这个图在不一定要见到商人才能获胜
1 5 2 在没有充足准备时别往上走
1 15 1 上面是一个走廊，左边有很多门，谨慎利用钥匙。小心毒酒
