10 3
601 204 403 103 404 103 403 204 503 2 
2 101 2 2 2 2 2 305 2 101 
2 204 103 0 0 204 0 306 101 204 
2 303 2 2 306 301 0 201 2 2 
2 2 2 504 0 2 2 2 2 503 
2 1 2 0 401 103 205 2 503 0 
201 106 2 2 101 2 2 2 2 402 
202 2 2 202 0 503 2 204 0 101 
501 2 2 2 401 2 2 0 2 0 
0 205 205 504 204 302 303 304 0 403 
101 0 401 0 306 0 204 0 304 304 
302 302 2 2 2 2 101 2 204 304 
301 2 2 601 301 302 303 0 0 0 
301 2 2 2 2 2 2 2 2 0 
401 204 202 202 204 202 202 204 2 0 
2 2 2 2 2 2 2 2 2 402 
106 502 2 601 2 2 2 0 204 305 
503 2 2 303 2 2 2 504 103 302 
0 202 2 0 2 601 403 0 303 0 
301 0 201 401 2 2 503 2 2 2 
204 101 101 303 303 2 101 2 306 306 
101 101 2 2 2 2 403 2 2 101 
304 204 204 101 101 401 601 402 204 401 
305 204 204 101 2 2 403 2 303 2 
101 101 101 101 204 2 504 2 101 0 
306 101 2 2 2 2 2 2 0 302 
204 204 401 201 101 101 2 303 0 2 
101 402 2 0 101 101 2 0 403 503 
101 101 2 2 103 2 2 403 2 2 
101 101 205 2 601 205 2 204 101 405 
1 1 10 1
1 3 10 坑人--->
1 7 10 <---坑人
1 5 5 别着急去右边，权衡利弊。
1 10 4 STOP!
1 5 2 温馨提示：上面是典型的十字地形！
1 10 1 告诉你一个秘密，1楼的东北角有很好的东西！
2 3 10 坑强迫症
2 4 8 1
2 1 6 静悄悄的走廊...
2 10 5 绕圈圈~
2 4 4 3
2 6 2 2
2 7 2 别往左，往下
2 4 1 需要特别小心了！
3 7 9 建议到上面去
3 6 8 先往右略有优势，左边有很多**。You know.
3 7 8 2
3 8 8 建议先走这边
3 10 8 武器！
3 7 7 建议别去下面
3 3 4 前方高能！
3 2 3 。。。
3 9 3 It's the key!--->
3 8 2 千万别到下面去！
3 5 1 3
