10 1
103 502 101 2 202 202 202 501 403 503 
303 2 0 2 202 402 202 2 1 106 
303 2 0 303 202 2 202 2 2 2 
101 101 301 2 402 2 0 0 101 504 
101 2 305 301 2 306 205 204 101 204 
303 2 306 2 101 2 2 2 204 503 
101 401 403 0 0 0 204 2 503 2 
301 201 503 404 503 503 201 2 303 303 
401 2 504 2 2 503 405 2 101 303 
0 301 301 301 2 503 2 2 303 103 
1 9 10 千万不要去下面
1 6 9 四个角上都很危险
1 5 7 能否通过上面的考验很考人品
1 2 4 我只是一个无辜的路牌
1 3 4 别往上
1 1 2 充分利用道具，不然你会吃亏的
