9 1
2 2 2 2 2 2 2 2 1 
502 103 101 101 401 305 204 2 106 
2 2 2 2 2 2 204 2 501 
504 402 2 304 304 0 403 306 503 
2 0 0 403 2 0 2 2 202 
2 2 301 0 2 0 0 305 402 
205 2 0 0 2 2 0 2 201 
103 2 306 2 2 204 401 2 103 
0 0 0 0 302 0 0 2 405 
1 5 8 没有拜访僧人之前请不要往左走
1 2 6 左边很安全，你可以捡到好东西
1 7 6 上面比较危险，没有足够的生命值千万不能去
1 4 5 里面很危险！
1 9 4 你最好等到生命值很低的时候再去下面，里面有很好的东西！
1 7 2 这里3格以内有很好的东西！
