15 1
503 101 0 0 0 2 405 0 303 0 204 2 2 106 1 
204 504 2 0 401 2 2 2 503 0 2 2 0 401 2 
403 403 2 2 201 0 503 301 401 2 2 305 0 0 2 
101 503 2 2 0 303 103 0 2 2 303 304 2 204 503 
2 401 504 401 302 0 101 306 0 2 2 2 2 201 0 
2 2 2 103 2 2 2 401 0 0 306 2 302 0 0 
303 503 0 0 2 502 2 202 2 0 0 2 103 2 301 
2 2 2 0 2 0 2 202 0 304 2 2 101 2 2 
0 402 306 305 2 205 2 2 2 103 2 305 401 0 303 
301 2 2 101 2 201 2 504 501 401 2 2 2 0 2 
0 101 2 402 401 403 2 0 2 2 2 0 205 0 2 
2 503 2 2 2 2 2 303 0 401 0 0 2 0 201 
0 402 403 0 204 504 2 2 2 101 2 403 2 2 2 
305 2 2 202 2 302 2 302 202 101 2 306 0 2 404 
0 504 303 0 402 304 2 504 204 503 2 2 301 0 403 
1 5 14 下面要小心
14 14 
1 1 13 上面很危险
1 2 13 我同意左边那个人
1 9 13 有准备就去上面
1 2 11 上面左右相邻两格间属性相同或相近
1 4 11 右边是一个3×4的区域，要小心谨慎
1 8 10 下面有一些酒
1 2 7 右边有好东西
1 13 7 往上要谨慎
1 10 6 如果你没有找到钥匙，再回去找找
1 4 5 右边那个是小人
1 5 5 左右两人有一个是小人
1 6 5 不要去上面，会死的
1 10 4 有准备了请往下走
1 2 3 上面很危险
1 3 3 左边是小人
1 12 3 别进去
1 5 1 右边很安全
1 15 1 真的别进去
