14 1
404 503 204 101 403 504 0 2 303 503 101 2 101 1 
503 2 2 2 0 2 0 101 0 2 405 2 0 503 
204 2 2 2 202 2 2 301 2 2 204 2 0 401 
101 2 2 2 0 2 306 0 0 2 2 2 2 501 
403 0 202 0 401 0 0 2 0 303 2 502 2 106 
0 2 2 2 0 2 304 2 2 0 2 205 2 403 
101 0 305 0 0 0 402 503 0 0 0 103 2 501 
303 2 2 2 2 2 2 2 2 2 2 402 2 0 
0 301 0 0 303 2 504 0 0 303 0 204 2 204 
101 2 0 2 101 0 0 0 2 0 302 0 2 0 
305 0 306 2 0 0 305 0 2 503 0 202 101 0 
0 2 2 2 0 2 2 302 2 0 2 2 2 2 
504 2 303 0 0 304 2 0 101 504 2 2 303 201 
0 204 0 0 2 0 0 0 2 403 0 103 402 502 
1 5 14 先往下走会吃亏的
1 14 12 最后的选择
1 1 10 先往右走会吃亏的
1 5 10 记住，左上角6×6区域以某条轴对称
1 14 9 这张地图没有Boss哦
1 7 8 去上面，别去右边
1 12 7 小心
1 10 1 建议早点去右边
1 13 1 千万不要得寸进尺
