17 1
2 2 2 2 2 2 2 2 306 2 202 202 202 202 202 202 205 
404 504 503 301 503 504 405 2 306 2 202 2 2 2 2 2 202 
2 2 2 501 2 2 2 2 304 2 202 2 503 501 401 2 202 
2 2 2 0 0 0 304 2 305 2 202 2 106 2 202 2 202 
2 2 2 2 2 502 0 2 304 2 202 2 1 2 202 202 202 
2 2 2 2 2 2 101 2 305 2 202 2 2 2 106 2 2 
204 0 303 0 0 2 101 2 501 2 202 202 301 403 401 204 204 
2 0 0 303 0 2 504 2 403 2 2 2 2 2 2 2 101 
2 0 0 0 303 0 0 2 401 2 503 0 301 0 0 0 0 
103 0 401 0 0 303 0 401 101 2 0 0 0 504 0 0 0 
2 2 303 0 2 2 2 2 503 2 401 0 0 0 301 0 101 
2 2 2 302 305 501 2 2 0 0 401 2 504 2 0 306 0 
2 2 306 401 2 502 503 2 0 204 401 101 2 101 0 0 305 
2 2 2 201 2 304 402 2 2 303 2 2 502 2 2 2 401 
301 302 301 403 2 2 402 2 504 403 402 101 103 0 0 2 0 
303 2 302 204 202 402 402 2 2 2 2 2 404 2 0 2 0 
0 303 301 204 2 402 402 2 2 2 2 2 2 2 302 503 0 
1 15 15 你需要1个钥匙，1条绳子及强大的攻击力或道具！
1 14 11 当然，这是要付出代价的......左边一格极其危险！请小心......
1 15 11 如果你很强大，就往上走；如果你想碰运气，那么往左
1 9 10 这里面是武器室！赶快进去拿吧！只需要一把钥匙哦~
1 9 9 记住：切勿有贪念！
1 3 8 (7,4)是君子......所以......
1 8 8 让我来告诉你这个地图的惊天大秘密！（也许现在已经晚了，但是我还是要告诉你......）如果你之前在（4,4）牺牲一点东西的话，也许后面的人和路牌说的话可以忽略掉......
1 11 7 又是这样......（作者实在不想编了！空间太大了。无力吐槽啊！）别忘了前面的忠告
1 11 6 往下走
1 4 5 不去下面就对了！
1 11 5 右边3*3区域摆成了一个5点的形状......东边和西边都是不好的
1 7 4 其实你不一定要所有地方都走的......
1 17 4 这是连通器
1 4 3 这确定一定以及肯定是你碰到的第一个君子！往上走就对了~
1 7 3 接下来的旅途一定会令你非常开心的！相信我哦^_^
1 10 3 左边很危险
1 11 3 可以不要那么早走这里，或许你可以走另外一边......
1 6 2 无语
1 7 2 无语
1 6 1 无语
1 7 1 无语
