13 1
405 2 503 204 401 402 103 204 103 302 204 204 106 
501 2 303 303 2 501 2 501 2 2 303 106 502 
404 2 303 2 201 106 2 306 504 2 2 302 2 
103 2 202 502 2 503 2 106 2 402 503 503 501 
503 2 101 2 202 202 2 201 205 2 2 103 2 
504 302 204 502 2 2 502 2 2 2 502 301 306 
504 2 2 502 501 502 502 2 404 302 103 103 301 
503 2 302 2 103 2 502 2 504 2 204 103 502 
101 2 101 305 501 303 501 303 504 305 2 501 2 
403 2 301 304 503 306 503 202 504 106 106 205 2 
402 2 201 306 2 205 204 2 501 2 503 503 503 
504 502 204 2 201 2 101 2 106 501 2 503 2 
0 504 205 402 402 402 402 106 2 106 501 503 1 
1 5 13 先去左上
1 6 13 门不要乱开
1 10 10 我只是个无辜的君子...
1 1 4 不要向上！
1 1 3 向上！
1 4 1 不要再向右走了
1 5 1 我再说一次，不要再向右走了！
1 6 1 你为什么不听呢！
1 7 1 立刻返回
