22 1
101 101 101 403 204 0 0 0 304 0 2 0 401 0 201 2 306 0 0 204 303 502 
502 2 2 2 0 2 303 0 0 0 204 0 2 2 0 2 504 0 2 103 2 205 
2 2 2 2 101 2 0 2 2 0 2 2 2 2 201 2 2 501 2 201 2 2 
301 0 302 2 0 0 0 101 0 0 202 0 0 2 502 2 0 401 401 401 0 202 
0 204 0 2 0 204 2 302 2 2 2 402 0 2 2 2 0 2 2 2 2 0 
305 0 304 2 2 204 2 401 2 202 202 0 401 0 204 501 301 0 304 0 2 303 
2 2 103 2 2 101 2 2 2 2 2 2 501 2 2 2 0 0 402 0 2 0 
205 2 503 2 504 0 2 1 2 405 103 0 202 501 106 2 2 2 201 0 302 0 
103 2 402 0 0 0 2 106 2 2 2 2 2 2 504 2 2 2 2 2 2 101 
204 2 2 2 2 0 2 0 103 2 0 503 2 202 204 2 404 204 103 103 401 0 
503 306 101 301 401 0 2 103 0 0 101 0 401 204 306 2 2 204 306 2 0 0 
2 2 2 2 2 305 2 2 2 2 2 2 2 2 2 2 2 2 2 2 2 101 
306 0 204 103 402 0 0 101 0 0 204 0 0 0 2 503 305 501 403 403 403 0 
0 2 0 2 2 301 401 0 2 0 2 2 303 0 2 2 2 2 2 2 2 0 
504 0 305 2 303 0 0 0 2 304 2 2 2 501 2 401 0 101 0 2 2 304 
103 2 101 2 0 2 2 0 2 0 2 402 0 204 2 301 2 2 504 0 0 0 
0 2 503 2 402 503 504 0 303 0 2 0 2 2 2 2 2 202 0 0 2 402 
501 2 205 2 0 2 0 2 2 0 2 0 401 201 202 201 2 305 0 306 2 0 
502 2 2 2 0 2 0 204 2 101 2 0 2 2 2 2 2 503 0 2 2 503 
502 2 0 306 304 403 101 2 2 0 2 0 2 2 0 103 0 402 101 202 2 103 
2 2 504 0 0 2 2 2 302 0 2 0 2 2 0 2 2 0 2 2 2 401 
0 0 302 0 303 2 2 202 306 0 2 402 0 0 303 2 2 202 2 103 205 306 
1 4 22 左边只有怪物，千万不要去
1 13 22 温馨提示：由于本地图有很多的...，所以快点找到商人比较好
1 18 19 去右边
1 19 19 左上方是门，右上方是地雷和进阶怪物，你想走哪边？
1 20 19 去左边
1 12 18 random！
1 8 17 终点在哪里？很近了...
1 13 17 附近门很密集
1 19 16 最好不要去下面
1 3 14 上面是宝库，不过...
1 21 13 如果你有实力，请去左边试试
1 5 12 左边一路你会遇到许多东西
1 13 12 没错，你踏上了终点的路，接下来没有道具可以捡了，尽量避免走多余的路
1 5 10 小心左边哦，准备好了再过去
1 19 10 对、对，一直往左走
1 20 10 左边真的有好东西
1 21 10 左边有好东西
1 7 9 温馨提示：如果你想打开所有的门，你的钥匙是不够的
1 16 8 据说附近有一个大阴谋，你遇到了吗？
1 12 7 走廊...
1 5 6 走上面，别走右边
1 22 6 小心
1 13 5 也许你需要照照右边是什么
1 6 3 快点去右边
1 18 3 如果你有闪光灯，请在此使用
1 22 2 不要有贪婪之心
1 12 1 走廊...
