10 1
1 101 2 2 204 302 103 501 0 306 
503 106 202 303 202 2 2 2 201 0 
2 2 2 2 2 2 306 2 2 301 
303 0 503 204 403 101 403 0 204 103 
0 303 2 402 503 2 304 305 2 103 
101 2 2 202 2 2 0 0 2 404 
306 2 2 0 0 2 503 305 2 205 
0 0 0 305 0 101 402 101 2 502 
2 2 504 2 304 2 201 2 2 2 
0 401 0 303 0 2 403 504 504 405 
1 5 7 左边很危险，右边很安全
1 7 7 不要去上面
1 4 6 右边很危险，上面很安全
1 7 3 小心我的四周
1 2 1 要学会利用自己的道具（如灯泡、手电筒）
1 7 1 你需要有两条绳子才能到右边去
