15 1
504 103 101 303 201 304 305 0 501 103 202 502 202 2 401 
103 2 2 101 2 2 2 2 2 301 504 202 2 2 106 
204 202 101 303 0 2 306 0 2 202 202 2 1 2 201 
204 2 0 2 0 101 0 101 2 404 2 205 106 2 501 
204 202 101 0 303 504 2 0 301 2 306 101 106 501 403 
101 2 2 204 2 303 0 305 0 2 2 2 2 2 202 
101 202 101 0 303 0 101 2 101 2 502 502 103 501 202 
101 2 2 2 2 2 2 504 501 2 2 2 2 2 202 
402 503 503 202 202 202 301 2 201 2 303 303 303 501 202 
202 2 2 2 2 202 306 2 103 2 2 2 2 2 202 
101 2 405 301 502 2 306 2 205 2 502 502 103 501 202 
303 2 204 305 304 2 101 301 2 2 2 2 2 2 202 
101 2 303 301 504 2 101 2 306 2 306 306 103 501 202 
401 2 2 2 403 2 0 2 103 2 2 2 2 2 202 
0 205 205 205 205 2 503 502 503 303 201 303 502 501 401 
1 15 15 终点在走廊左边最后一扇门的最深处
1 15 11 终点在上面
1 1 7 艰辛的旅程即将开始~
1 1 2 这个图在不一定要见到商人才能获胜
1 5 2 在没有充足准备时别往上走
1 15 1 上面是一个走廊，左边有很多门，谨慎利用钥匙。小心毒酒
