10 1
502 2 2 2 402 0 103 304 2 1 
503 101 0 2 0 2 2 306 2 106 
2 2 401 2 402 503 2 2 2 501 
301 0 0 202 0 403 0 305 0 503 
0 2 2 2 204 0 0 2 2 0 
101 401 0 2 2 2 101 2 2 204 
2 2 204 0 0 0 401 0 0 0 
2 302 101 2 2 402 2 2 301 0 
2 2 0 304 2 0 201 2 2 2 
0 401 504 0 2 2 0 504 101 405 
1 5 10 加油
1 3 8 easy one！
1 5 8 不要去右边
1 6 7 快点去上面
1 2 5 你不一定要往左走的
1 7 4 别着急去（10，7）
1 6 3 要小心了
1 2 1 本局的难点在于打败Boss，祝一路顺风
