20 1
502 0 103 0 0 0 403 305 2 501 0 503 0 401 303 204 0 0 106 1 
2 205 2 2 302 0 2 2 2 0 2 2 0 0 304 202 0 503 2 2 
2 2 2 101 0 0 2 2 2 305 2 2 2 2 2 2 2 2 2 503 
0 0 301 0 2 2 2 2 2 0 202 2 2 304 0 2 0 0 0 403 
303 2 2 0 2 0 0 403 0 0 0 0 0 0 0 2 101 2 2 0 
0 2 2 204 2 201 2 2 2 2 2 2 2 2 401 2 0 2 2 202 
0 0 504 404 2 503 2 2 0 101 403 303 302 101 0 2 303 0 2 202 
103 2 2 2 2 2 2 401 0 503 403 204 306 201 0 2 0 0 2 202 
0 2 204 0 0 202 0 0 2 2 2 2 2 2 2 2 0 0 2 401 
402 2 2 2 2 0 0 0 2 301 0 205 2 0 0 0 305 305 0 0 
0 0 205 101 2 2 2 101 2 0 0 101 2 0 503 0 2 2 2 0 
0 504 0 0 2 303 0 0 2 503 2 2 2 0 402 402 0 0 0 0 
0 0 0 0 2 0 0 306 2 403 0 0 0 0 2 302 2 2 0 306 
306 0 303 0 2 2 2 0 2 2 2 2 2 0 2 0 2 2 0 0 
2 2 2 401 2 304 0 0 0 503 0 401 103 0 504 0 0 2 2 0 
204 0 0 504 2 0 0 0 2 2 2 0 2 2 2 2 0 301 2 201 
0 0 2 2 2 2 0 2 2 504 2 0 2 0 503 2 0 0 101 0 
101 304 2 503 402 0 0 2 0 0 2 0 0 204 0 2 2 2 405 2 
401 2 2 2 305 2 101 0 0 0 0 0 2 0 401 0 403 2 2 2 
0 0 504 0 0 2 2 0 301 2 503 0 0 0 2 0 401 202 101 402 
1 1 2 上面是一条探险道路，请小心
1 1 11 请勿过早往上走
1 4 6 上面是一个4×4的方格区域，大部分是好东西
1 5 3 不要去左边
1 7 20 千万不要往右走
1 8 13 右边是一个2×N的大道，上下相邻的两格相同或属性相近
1 8 16 有足够的生命值才可往里走
1 10 8 上面是一根绳子
1 11 13 右边很危险
1 11 14 （18,19）处有好东西
1 12 6 小心！
1 14 20 有趣的地方
1 15 2 往右走你可得到一些信息
1 15 9 上面很危险，右边是君子
1 15 15 你至少需要一条绳子
1 16 9 下面很安全，左边是君子
1 17 1 本地图共有5个君子，7个小人，8个路牌
1 17 2 （6，14）对你有帮助 
1 20 1 在地图右下角3×3的区域内，除我外还有一个人
1 20 12 上面有三瓶酒
1 20 17 快要到终点了
