15 1
404 2 306 0 0 403 302 303 0 305 0 202 501 106 1 
103 2 0 2 504 2 0 2 0 2 204 2 2 2 2 
501 2 204 402 101 0 0 503 0 101 0 0 301 0 306 
202 2 0 2 0 2 2 2 2 2 0 2 0 2 101 
401 0 101 0 205 303 304 403 402 0 302 0 402 503 0 
305 2 0 2 0 2 2 101 2 2 0 2 0 2 0 
0 0 301 0 0 2 502 101 204 2 0 0 101 0 201 
0 2 0 2 302 2 503 2 503 2 503 2 0 2 402 
302 0 0 304 403 2 502 201 502 2 0 204 403 504 0 
503 2 504 2 0 2 2 2 2 2 303 2 0 2 305 
304 0 101 0 0 202 202 202 202 202 306 0 0 0 401 
402 2 0 2 303 2 504 2 0 2 0 2 205 2 202 
301 0 204 0 0 0 101 0 302 0 0 304 0 2 501 
2 2 2 2 401 2 0 2 403 2 0 2 0 2 103 
0 204 301 204 401 401 303 0 301 503 0 305 101 2 405 
1 6 15 右边很危险！
1 4 13 右边比较危险
1 1 11 (1,6)和(8,13)是陷阱;(3,11)和(5,13)是怪物
1 8 11 下面什么也没有......
1 9 11 左边的是小人//你最好不要去(8,7)......
1 13 11 不要去右边......
1 15 8 上面很危险
1 5 7 不要去上面！
1 13 7 左边很安全，但是右边很危险！
1 15 5 (10,1)和(11,8)是陷阱;(13,1)和(15,12)是怪物
1 1 4 上面很安全//下面很安全......
1 5 2 友情提示2：有5个小人和5个君子......
1 9 2 千万不要去上面......
1 5 1 友情提示：四个角上都有好东西！所以......越早到越好,但是在这之前可以去中间（当然也可以先不去，但那是迟早要去的）
1 6 1 (14,15)是BOSS！
